######
#A   ##
# @ @ #
# #o o#
#     #
#######