###########
#A        #
#    @   ##
###    ##
#o     ##
# @  o##
########