 #####
 #   ####
 #  @   #
 #      #
###@###o#
#   # #o#
#   # ###
# A #
#####
