##############
#oo   @  A   #
#oo   #   @  #
### ###### ###
#      @ @   #
#            #
##############