################
#oo            A#
#oo   @   #@    #
#oo       #     #
##### @#### ####
#    @  @ @   #
#            #
#############